111111111111111
111111050111111
100000000000001
100000000000001
100000000000001
100001111111111
100001050111111
100000000000001
100000000000001
100000000000001
100000040000001
100000111000001
100000111000001
120000111000031
111111111111111
