11111111111111111
10501050105010501
10000000000000001
10000020403000001
10000000000000001
10501050105010501
11111111111111111
